......................
.####################.
.#..................#.
.#..................#.
.#..................#.
.#..................#.
.#..................#.
.#..................#.
.#..................#.
.#..................#.
.#..................#.
.#..................#.
.#..................#.
.#..................#.
.#..................#.
.#..................#.
.#..................#.
.#..................#.
.#..................#.
.#@.................#.
.####################.
......................