###################################################################
#?...............................................................?#
#..........#.....................##################...............#
#..........#..............#.......#...............#...............#
#..........#..............#.......................#...............#
#........##########.....#########....########.....#...............#
#.................................................##########......#
#.......................#.........................#...............#
############.......######.........................................#
#..........#............#......................#..................#
#..........#............#......................#..................#
#..........#...................................############.......#
#.....######............#......................#..................#
#..........#............#.............##########..................#
#..........#............#......................#..................#
#..........######.......#........@.............#..................#
#..........#............#.................................#########
#..........#..................................................#...#
#.......................#.....................#...............#...#
#.......................#########.............#...............#...#
#.......................#.....................#...............#...#
#.......................#................#########............#...#
#.......#..................................#..................#...#
#.......#.....................#............#..................#...#
#......#########..............#............#......................#
#......#.....#................#......................######.......#
#......#.....##..........#############............................#
#......#.........................#................#####...........#
#?...............................................................?#
###################################################################